###############################
#,,,,,,,,,,,,,,,,,,,,,,,,,,,,,#
#,,,,,,,,,##########,,,,,,,,,,#
#,,#,,,,,,,,,,,,,,,#,,,,,,,,,,#
#,#,,,,,,,,,,,,,,,,#,,,,,,,,,,#
#,,#,,,,,,,,,,,,,,,#,,,,,,,,,,#
#,,,#,,,,,,,,,,,,,,,,,,,,,,,,,#
#,,#,,,,###,,,,,,,,,,,#,,,,,,,#
#,,,,,,,#,#,,,,,,,,,,,#,,,,,,,#
#,,,,,,,###,,,,,,,,,,,#,,,,,,,#
#,,,,,,,,,,,,,,,,,,,,,#,,,,,,,#
#,,,,,,,,,,,,,,,,,,,,,#,,,,,,,#
#,,,,,,,,,,,,,,,,,,,,,#,,,,,,,#
#,,,,,,,,,,,,,,,,,,,,,#,,,,,,,#
#,,,,,,,,,,,,,,,,,,,,,,,,,,,,,#
###############################