##############################################################################
#mmmmmmmmmmmmmmmmmmmmmmmmmmmmmmm#,,,,,,,,,,,,^^^^^^^^^^^^^^^^^^^^^^^^^^^^^^^^#
#mmmmmmmmmmmmmmmmmmmmmmmmmmmmmmm#,,,,,,,,,,,,,,,,,,,^^^^^^^^^^^^^^^^^^^^^^^^^#
#mmmmmmmmmmmmmmmmmmmmmmmmmmmmmmm#,,,,,,,,,,,,,,,,,,,,^^^^^^^^^^^^^^^^^^^^^^^^#
#mmmmmmmmmmmmmmmmmmmmmmmmmmmmmmm#,,,,,,,,,,,,,,,,,,^^^^^^^^^^^^^^^^^^^^^^^^^^#
#mmmmmmmmmmmmmmmmmmmmmmmmmmmmmmm#,,,,,,,,,,,,,,,,,,,,,,,,,,^^^^^^^^^^^^^^^^^^#
#mmmmmmmmmmmmmmmmmmmmmmmmmmmmmmm#,,,,,,,,,,,,,,,,,,,,,,,,,,,,,,,,^^^^^^^^^^^^#
#mmmmmmmmmmmmmmmmmmmmmmmmmmmmmmm#,,,,,,,,,,,,,,,,,,,,,,,,,,,,,,,,,,,,,,,,,,,,#
###############D#################,,,,,,,,,,,,,,,,,,,,,,,,,,,,,,,,,,,,,,,,,,,,#
#,,,,,,,,,,,,,,,,,,,,,,,,,,,,,,,,,,,,,,,,,,,,,,,,,,,,,,,,,,,,,,,,,,,,,,,,,,,,#
#,,,,,,,,,,,,,,,,,,,,,,,,,,,,,,,,,,,,,,,,,,,,,,,,,,,,,,,,,,,,,,,,,,,,,,,,,,,,#
#,,,,,,,,,,,,,,,,,,,,,,,,,,,,,,,,,,,,,,,,,,,,,,,,,,,,,,,,,,,,,,,,,,,,,,,~,,,,#
#,,,,,,,,,,,,,,,,,,,,,,,,,,,,,,,,,,,,,,,,,,,,,,,,,,,,,,,,,,,,,,,,,,,,~~~,,,,,#
#,,,,,,,,,,,,,,,,,,,,,,,,,,,,,,,,,,,,,,,,,,,,,,,,,,,,,,,,,,,,,,,,,,,,~,,,,,,,#
#,,,,,,,,,,,,,,,,,,,,,,,,,,,,,,,,,,,,,,,,,,,,,,,,,,,,,,,,,,,,,,,,,,~~,,,,,,,,#
#,,,,,,,,,,,,,,,,,,,,,,,,,,,,,,,,,,,,,,,,,,,,,,,,,,,,,,,,,,,,,,,,,~,,,,,,,,,,#
#,,,,,,,,,,,,,,,,,,,,,,,,,,,,,,,,,,,,,,,,,,,,,,,,,,,,,,,,,,,,,,~~~,,,,,,,,,,,#
#,,,,,,,,,,,,,,,,,,,,,,,,,,,,,,,,,,,,,,,~~~~~~~,,,,,,,,,,,,,,,,~~,,,,,,,,,,,,#
#,,,,,,,,,,,,,,,,,,,,,,,,,,,,,,,,~~~~~~~~~~~~~~~~~~~,,,,,,,~~,,,,,,,,,,,,,,,,#
#,,,,,,,,,,,,,,,,,,,,,,,,,,,~~~~~~~~~~~~~~~~~~~~~~~~~~~,,,~~,,,,,,,,,,,,,,,,,#
#,,,,,,,,,,,,,,,,,,,,,,,~~~~~~~~~~~~~~~~~~~~~~~~~~~~~~~~~~~,,,,,,,,,,,,,,,,,,#
#,,,,,,,,,,,,,,,,,,,,~~~~~~~~~~~~~~~~~~~~~~~~~~~~~~~~~~~~~~~~~~,,,,,,,,,,,,,,#
#,,,,,,,,,,,,,,,,~~~~~~~~~~~~~~~~~~~~~~~~~~~~~~~~~~~~~~~~~~~~~~~~~,,,,,,,,,,,#
#,,,,,,,,,,,,,,~~~~~~~~~~~~~~~~~~~~~~~~~~~~~~~~~~~~~~~~~~~~~~~~~~~~~~,,,,,,,,#
##############################################################################